R         1920    1080    
NO        ./path_to_the_north_texture
SO ./path_to_the_south_texture
WE ./path_to_the_west_texture
EA ./path_to_the_east_texture
S ./path_to_the_sprite_texture
F 229,111,200
C 244,020,50
000
11111111111111111111111111111111111
222
3333333333333333333333333333333333333333333333333333333333333333333333333333333333333333333333333333
444
555
666
777
888
999
100
101
102
103
104
105
106     