R         800    600    
NO        ./textures/bluestone.xpm
SO ./textures/eagle.xpm
WE ./textures/greenlight.xpm
EA ./textures/greystone.xpm
S ./textures/barrel.xpm
F 229,111,200
C 244,020,50



1111111111111111111111111
1111111111111111111111111
1100000000000000000000011
1110000000000110000000011
1100000000000000000000111
1111111111111111111111111
1111111111111111111111111